000000000000000000
011111101011101110
010100101010111010
011100111110100010
010111111010111110
011101001111100100
001111111010111100
001001001110100100
011111101011111110
110100101010101011
011100111111101010
010111111010111110
011101001011101010
010001001001001010
010111101111111110
011100111110000010
010101110011110110
011111011110011100
000000000000000000
