0000000000000000000
0111111110111111110
0100100010100010010
0111111111111111110
0100101000001010010
0111101110111011110
0100100010100010010
0111101111111011110
0000101001001010000
1111111011101111111
0000101000001010000
0111101111111011110
0100101000001010010
0111111110111111110
0100100010100010010
0110111111111110110
0010101000001010100
0111101110111011110
0100000010100000010
0111111111111111110
0000000000000000000
