000000000000000000
010101010111101110
011111111111111010
011010101010100010
010111111101111110
011101010111100100
001111011110111100
001001001110100100
011101111011111110
110111101010101011
011100111111101010
010111111010111110
011101001011101010
010001001001001010
010111101111001010
011101110010111110
001001011110100110
011111000111111100
000000000000000000
