000000000000000000
011111011101111110
010101110111010010
010100010100011110
011110010111010010
001011110001111110
001001000000001010
001111111100001110
011100011101111010
110111110111010011
011101000101011110
010111100101010100
011110111101010100
001001110111011100
011011111101010100
010010101101010100
011111110111011110
010000011101111100
000000000000000000
